....................
..########..........
.........#..........
.........#..........
.........######.....
..............#.....
..............#.....
..............#.....
.........######......
....................
....................
...#############....
....................
............#.......
............#.......
............#.......
##.###......#.......
.....#......####....
...................#
.....#............##