######.........#####
....................
.......####........#
..........#........#
###.......####...###
..........#........#
..........####.....#
....................
#####...........####
....................
....############....
....................
#####..........#####
....................
#......####..#......
#.........#..#......
#.........####......
#.........#.........
..........####......
####..............##