....................
....................
...#................
...#................
...#........####....
...#####.......#....
...............#....
............#..#....
............#.......
............#.......
.....#......####....
.....#..............
#....#####......##..
#........#......##..
#........#......##..
#####...........##..
....................
.......########.....
#.............#.....
########............