....................
...............#....
...............#....
....#.....#######....
...###.........#....
....#..........#....
...............#....
#...................
#.........#.........
#.......#####.......
#.........#.........
######........#.....
..............#.....
..............#.....
....................
.....#########......
....................
######........#.....
..............#.....
#.............#....#