....................
....................
....................
####################
....................
.###................
...#...............#
...#...............#
...#####..#........#
...................#
.............#.....#
..#######..........#
........#...........
........#...........
........#...........
........#...........
###.....##########..
....................
.....##........##...
.........##......###