######.........#####
....................
.......####..#.....#
..........#..#.....#
###....#######...###
.......#..#........#
.......#..####.....#
....................
#####...........####
....................
....############....
....................
#####..........#####
....................
#......####..#......
#.........#..#......
#......#######......
#......#..#.........
.......#..####......
####..............##